
...###..########
..##*#.#...*...#
.##b.###....b..#
##......*.#....#
#@.....#..#....#
###..###..#....#
###..#....#....#
###.##.#b##..###
#.......##...*.#
#bbbbb######.d.#
################