
...#############
###.*#.#...*...#
#@#b.#.#....b..#
#.......*.#....#
#......#..#....#
###..###..#....#
###..#....#....#
##..##.#b##..###
#.......##b....#
#.b..d######...#
################