........########
...######*.....#
###*....######.#
#............#.#
#.##########.#.#
#.#........#.#.#
#.#.#..d...#.#.#
#.#.########.#.#
#.#..........#.#
#.############.#
#@.............#
################